51 51 51 54 31 56 51 51 51 51 51 51 51 51 51 51 51 51 51 51 51 51 51 51 51 51 51 51 51 51 51 51 51 51 51 51 51 51 51 51 51 51 51 51 51 51 51 51 51 51
51 51 51 67 53 66 51 51 51 51 51 51 51 51 51 51 51 51 51 51 51 51 51 51 51 51 51 51 51 51 51 51 51 51 51 51 51 51 51 51 51 51 51 51 51 51 51 51 51 51
51 51 51 51 51 51 51 51 51 51 51 51 51 51 62 55 55 55 55 55 55 55 55 55 55 55 55 55 55 55 55 55 55 55 55 55 55 55 55 55 55 55 55 55 55 55 55 55 65 51
51 51 51 51 51 51 51 51 51 51 51 51 51 51 54 21 21 21 21 21 21 21 21 21 21 21 31 31 31 31 31 31 31 31 31 31 31 31 31 31 31 31 31 31 31 31 21 21 56 51
51 51 51 51 51 51 51 51 51 51 51 51 51 51 54 21 21 21 21 21 21 21 21 21 21 31 15 11 11 11 11 11 11 11 11 11 11 11 11 11 11 11 11 11 11 16 31 21 56 51
51 51 51 51 51 51 51 51 51 51 51 51 51 51 54 21 21 21 21 21 21 21 21 21 21 31 11 11 11 11 11 11 11 11 11 11 11 11 11 11 11 11 11 11 11 11 31 21 56 51
51 51 51 51 51 51 51 51 51 51 51 51 62 21 21 21 21 21 21 21 21 21 21 21 21 31 11 11 11 11 11 11 11 11 11 11 11 11 11 11 11 11 11 11 11 11 31 21 56 51
51 51 51 51 51 51 51 51 51 51 51 51 54 21 21 21 21 21 21 21 21 21 21 21 21 31 11 11 11 11 11 11 11 11 11 11 11 11 11 11 11 11 11 11 11 11 31 21 56 51
51 51 51 51 51 51 51 51 51 51 51 51 54 21 21 21 21 21 21 21 21 21 31 31 21 31 14 11 11 11 11 11 11 11 11 11 11 11 11 11 11 11 11 11 11 17 31 21 56 51
51 51 51 51 51 51 51 51 51 51 51 51 54 21 21 21 21 21 21 21 21 21 32 32 31 21 31 31 31 31 31 31 31 31 31 31 21 31 31 31 31 31 31 31 31 31 21 21 56 51
51 51 51 51 62 55 63 51 51 51 51 51 67 21 21 21 21 21 21 21 21 21 15 31 32 31 21 31 21 31 21 31 21 31 21 31 21 31 21 31 21 31 21 31 21 31 21 31 56 51
51 51 51 51 54 31 56 51 51 51 51 51 51 51 54 21 31 21 21 21 31 15 17 32 31 32 31 32 31 32 31 32 31 32 31 32 21 32 21 32 31 32 31 32 31 32 31 32 56 51
51 51 51 51 67 53 64 51 51 51 51 51 51 51 54 21 32 31 31 31 32 13 31 21 32 31 32 31 32 31 32 31 32 31 32 31 21 31 21 31 32 31 32 31 32 31 32 31 56 51
51 51 51 51 51 51 51 51 51 51 51 51 51 51 54 21 31 32 32 32 31 13 32 31 21 32 31 32 31 32 31 32 31 32 31 32 21 32 31 32 31 32 31 32 31 32 31 32 56 51
51 51 51 51 51 51 62 55 55 55 63 51 51 51 54 21 32 31 31 31 32 13 31 32 21 23 32 23 32 21 32 22 32 21 32 23 21 23 32 23 32 21 32 22 32 21 32 23 56 51
51 51 51 51 51 51 54 21 21 21 56 51 51 51 54 21 31 32 32 32 31 13 32 31 21 21 21 21 21 21 21 21 21 21 21 21 21 21 21 21 21 21 21 21 21 21 21 21 56 51
51 62 55 63 51 51 67 53 21 21 66 51 51 51 54 21 32 31 31 21 32 13 31 32 21 31 21 31 21 31 21 31 21 31 21 31 21 31 21 31 21 31 21 31 21 31 21 31 56 51
51 54 21 56 51 51 51 51 67 66 51 51 51 51 54 21 21 32 32 31 15 17 32 31 21 32 31 32 31 32 21 32 31 32 31 32 21 32 31 32 31 32 31 32 31 32 31 32 56 51
51 54 21 56 51 51 51 51 51 51 51 51 51 51 54 21 21 31 31 32 13 31 21 32 21 31 32 31 32 31 21 31 32 31 32 21 21 21 32 31 32 31 32 31 32 31 32 31 56 51
51 54 22 21 63 51 51 51 51 51 51 51 51 68 21 21 31 32 32 21 13 32 31 21 21 31 31 32 31 32 31 32 31 32 21 21 21 21 21 32 31 32 31 32 31 32 31 32 56 51
51 54 21 21 21 55 55 55 55 55 55 55 55 21 21 21 32 31 31 21 13 31 32 21 31 32 32 21 32 21 32 22 32 21 21 21 21 21 21 21 32 21 32 22 32 21 32 21 56 51
51 54 21 21 21 21 31 21 31 21 21 21 31 21 31 21 31 32 32 15 17 32 31 21 32 31 21 31 21 31 22 31 21 31 21 21 21 21 21 31 21 31 21 31 21 21 21 21 56 51
51 54 21 31 31 31 32 31 32 31 21 31 32 31 32 31 32 31 21 13 31 21 32 21 31 32 31 32 31 32 31 32 31 32 31 21 21 21 31 32 31 32 31 32 21 22 31 21 56 51
51 54 21 32 32 32 21 32 31 32 31 32 31 32 31 32 21 32 15 17 32 31 21 31 32 31 32 31 32 31 32 31 32 31 32 31 21 31 32 31 32 31 32 31 21 31 32 31 56 51
51 54 22 31 31 31 21 31 32 31 32 31 32 31 32 31 21 31 13 21 21 32 31 32 31 32 31 32 31 32 31 32 31 32 31 32 31 32 31 32 31 32 31 32 31 32 31 32 56 51
51 54 21 32 32 32 23 32 23 32 21 32 22 32 21 32 23 32 11 16 21 21 32 21 32 23 32 23 32 21 32 22 32 21 32 23 32 23 32 23 32 21 32 22 32 21 32 21 56 51
51 54 21 21 21 21 21 21 21 21 22 21 21 21 21 21 22 15 11 11 16 21 21 21 21 21 22 21 21 21 21 21 21 21 21 22 21 21 21 21 22 21 21 21 21 21 21 21 56 51
51 54 21 12 12 12 12 12 12 12 12 12 12 12 12 12 12 11 11 11 11 12 12 12 12 12 12 12 12 12 12 12 12 11 11 12 12 12 12 12 12 12 12 12 12 12 12 21 56 51
51 54 21 21 31 31 31 21 31 31 31 21 21 31 21 31 21 14 11 11 17 21 21 21 21 21 31 31 31 31 31 31 21 11 11 21 31 31 31 31 31 31 31 31 21 31 31 31 56 51
51 54 21 21 32 32 32 31 32 32 32 21 31 32 31 32 21 21 14 11 21 21 21 31 21 31 32 32 32 32 32 32 31 11 11 31 32 32 32 32 32 32 32 32 31 32 32 32 56 51
51 54 22 21 23 31 21 32 21 31 31 21 32 21 32 21 31 21 21 13 21 21 31 32 21 32 23 23 23 23 23 23 31 11 11 31 23 23 23 23 23 23 21 21 32 31 21 31 56 51
51 54 21 31 21 32 21 31 31 32 32 14 16 21 31 31 32 21 21 13 31 21 32 21 21 31 23 23 23 23 23 23 31 11 11 31 23 23 23 23 23 23 21 21 21 32 31 32 56 51
51 54 21 32 31 31 31 32 32 23 31 23 13 31 32 32 31 31 21 13 32 31 31 22 31 32 21 21 31 31 31 31 31 11 11 31 31 31 31 31 21 22 21 21 31 31 32 31 56 51
51 54 21 31 32 32 32 23 23 21 32 15 17 32 31 21 32 32 22 13 31 32 32 21 32 21 21 31 15 11 11 11 11 11 11 11 11 11 11 16 31 21 21 21 32 32 31 32 56 51
51 54 21 32 31 31 21 21 31 21 22 13 23 31 32 31 31 31 21 13 32 31 31 21 21 21 21 31 11 11 11 11 11 11 11 11 11 11 11 11 31 21 22 21 21 31 32 31 56 51
51 54 21 22 32 32 31 21 32 31 15 17 31 32 31 32 32 32 31 13 31 32 32 21 21 21 22 31 11 11 11 11 11 11 11 11 11 11 11 11 31 21 21 21 21 32 31 32 56 51
51 54 21 21 31 31 32 31 21 32 13 21 32 21 32 21 21 31 32 13 32 31 31 21 21 21 21 31 11 11 11 11 11 11 11 11 11 11 11 11 31 21 21 21 31 21 32 31 56 51
51 54 21 31 32 32 21 32 21 15 11 16 23 21 21 23 21 32 31 13 31 32 32 21 21 21 21 31 11 11 11 11 11 11 11 11 11 11 11 11 31 21 21 21 32 21 31 32 56 51
51 54 21 32 21 31 31 21 15 11 11 11 16 23 22 21 21 31 32 13 32 31 31 21 22 21 21 31 11 11 11 11 11 11 11 11 11 11 11 11 31 21 21 21 31 21 32 31 56 51
51 67 21 31 31 32 32 15 11 11 11 11 11 16 21 22 31 32 22 13 31 32 32 21 21 21 21 31 14 11 11 11 11 11 11 11 11 11 11 17 31 21 21 22 32 31 31 32 56 51
51 51 54 32 32 31 21 11 11 11 11 11 11 11 31 31 32 21 21 13 32 31 31 21 21 21 21 21 31 31 31 31 31 31 31 31 31 31 31 31 21 21 21 21 31 32 32 21 56 51
51 51 54 21 31 32 31 11 11 11 11 11 11 11 32 32 31 31 21 13 31 32 32 21 21 21 22 21 21 21 21 21 21 21 22 21 21 21 21 21 21 22 21 21 32 31 31 21 56 51
51 51 54 31 32 31 32 11 11 11 11 11 11 11 31 31 32 32 21 13 32 31 31 21 21 21 21 31 31 31 31 31 31 31 31 31 31 31 31 31 31 21 21 21 22 32 32 31 56 51
51 62 21 32 31 32 23 14 11 11 11 11 11 17 32 32 31 31 21 13 31 32 32 21 21 21 21 32 32 32 32 32 32 32 32 32 32 32 32 32 32 21 21 21 21 21 31 32 56 51
51 54 21 31 32 31 21 23 14 11 11 11 17 21 22 31 32 32 15 11 32 31 31 31 31 31 31 31 31 31 31 31 31 31 31 31 31 31 31 31 31 31 31 31 31 31 32 31 56 51
51 54 21 32 31 32 31 31 31 31 31 31 31 31 31 32 31 21 11 11 16 32 32 32 32 32 32 32 32 32 32 32 32 32 32 32 32 32 32 32 32 32 32 32 32 32 21 32 56 51
51 54 21 21 32 21 32 32 32 32 32 32 32 32 32 21 32 21 21 14 11 12 12 12 12 12 12 12 12 12 12 12 12 12 12 12 11 16 21 21 21 21 21 21 21 21 21 21 56 51
51 61 53 53 53 53 53 53 53 53 53 53 53 53 53 53 53 53 53 53 53 53 53 53 53 53 53 53 53 53 53 53 53 53 53 53 14 11 21 53 53 53 53 53 53 53 53 53 66 51
51 51 51 51 51 51 51 51 51 51 51 51 51 51 51 51 51 51 51 51 51 51 51 51 51 51 51 51 51 51 51 51 51 51 51 51 54 11 56 51 51 51 51 51 51 51 51 51 51 51
51 51 51 51 51 51 51 51 51 51 51 51 51 51 51 51 51 51 51 51 51 51 51 51 51 51 51 51 51 51 51 51 51 51 51 51 54 11 56 51 51 51 51 51 51 51 51 51 51 51