99 99 99 99 33 99 99 99 99 99 99 99 99 99 99 99 99 99 99 99 99 99 99 99 99 99 99 99 99 99 99 99 99 99 99 99 99 99 99 99 99 99 99 99 99 99 99 99 99 99
99 99 99 99 99 99 99 99 99 99 99 99 99 99 99 99 99 99 99 99 99 99 99 99 99 99 99 99 99 99 99 99 99 99 99 99 99 99 99 99 99 99 99 99 99 99 99 99 99 99
99 99 99 99 99 99 99 99 99 99 99 99 99 99 99 99 99 99 99 99 99 99 99 99 99 99 99 99 99 99 99 99 99 99 99 99 99 99 99 99 99 99 99 99 99 99 99 99 99 99
99 99 99 99 99 99 99 99 99 99 99 99 99 99 99 99 99 99 99 99 99 99 99 99 99 99 33 33 33 33 33 33 33 33 33 33 33 33 33 33 33 33 33 33 33 33 99 99 99 99
99 99 99 99 99 99 99 99 99 99 99 99 99 99 99 99 99 99 99 99 99 99 99 99 99 33 99 99 99 99 99 99 99 99 99 99 99 99 99 99 99 99 99 99 99 99 33 99 99 99
99 99 99 99 99 99 99 99 99 99 99 99 99 99 99 99 99 99 99 99 99 99 99 99 99 33 99 99 99 99 99 99 99 99 99 99 99 99 99 99 99 99 99 99 99 99 33 99 99 99
99 99 99 99 99 99 99 99 99 99 99 99 99 99 99 99 99 99 99 99 99 99 99 99 99 33 99 99 99 99 99 99 99 99 99 99 99 99 99 99 99 99 99 99 99 99 33 99 99 99
99 99 99 99 99 99 99 99 99 99 99 99 99 99 99 99 99 99 99 99 99 99 99 99 99 33 99 99 99 99 99 99 99 99 99 99 99 99 99 99 99 99 99 99 99 99 33 99 99 99
99 99 99 99 99 99 99 99 99 99 99 99 99 99 99 99 99 99 99 99 99 99 33 33 99 33 99 99 99 99 99 99 99 99 99 99 99 99 99 99 99 99 99 99 99 99 33 99 99 99
99 99 99 99 99 99 99 99 99 99 99 99 99 99 99 99 99 99 99 99 99 99 99 99 33 99 33 33 33 33 33 33 33 33 33 33 99 33 33 33 33 33 33 33 33 33 99 99 99 99
99 99 99 99 99 99 99 99 99 99 99 99 99 99 99 99 99 99 99 99 99 99 99 33 99 33 99 33 99 33 99 33 99 33 99 33 99 33 99 33 99 33 99 33 99 33 99 33 99 99
99 99 99 99 99 33 99 99 99 99 99 99 99 99 99 99 33 99 99 99 33 99 99 99 33 99 33 99 33 99 33 99 33 99 33 99 99 99 33 99 33 99 33 99 33 99 33 99 99 99
99 99 99 99 99 99 99 99 99 99 99 99 99 99 99 99 99 33 33 33 99 99 33 99 99 33 99 33 99 33 99 33 99 33 99 33 99 33 99 33 99 33 99 33 99 33 99 33 99 99
99 99 99 99 99 99 99 99 99 99 99 99 99 99 99 99 33 99 99 99 33 99 99 33 99 99 33 99 33 99 33 99 33 99 33 99 99 99 33 99 33 99 33 99 33 99 33 99 99 99
99 99 99 99 99 99 99 99 99 99 99 99 99 99 99 99 99 33 33 33 99 99 33 99 99 99 99 99 99 99 99 99 99 99 99 99 99 99 99 99 99 99 99 99 99 99 99 99 99 99
99 99 99 99 99 99 99 99 99 99 99 99 99 99 99 99 33 99 99 99 33 99 99 33 99 99 99 99 99 99 99 99 99 99 99 99 99 99 99 99 99 99 99 99 99 99 99 99 99 99
99 99 99 99 99 99 99 99 99 99 99 99 99 99 99 99 99 33 33 99 99 99 33 99 99 33 99 33 99 33 99 33 99 33 99 33 99 33 99 33 99 33 99 33 99 33 99 33 99 99
99 99 99 99 99 99 99 99 99 99 99 99 99 99 99 99 33 99 99 33 99 99 99 33 99 99 33 99 33 99 33 99 33 99 33 99 99 99 33 99 33 99 33 99 33 99 33 99 99 99
99 99 99 99 99 99 99 99 99 99 99 99 99 99 99 99 99 33 33 99 99 33 99 99 99 33 99 33 99 33 99 33 99 33 99 99 99 99 99 33 99 33 99 33 99 33 99 33 99 99
99 99 99 99 99 99 99 99 99 99 99 99 99 99 99 99 33 99 99 99 99 99 33 99 99 33 33 99 33 99 33 99 33 99 99 99 99 99 99 99 33 99 33 99 33 99 33 99 99 99
99 99 99 99 99 99 99 99 99 99 99 99 99 99 99 99 99 33 33 99 99 33 99 99 33 99 99 99 99 99 99 99 99 99 99 99 99 99 99 99 99 99 99 99 99 99 99 99 99 99
99 99 99 99 99 99 33 99 33 99 33 99 33 99 33 99 33 99 99 99 99 99 33 99 99 33 99 33 99 33 99 33 99 33 99 99 99 99 99 33 99 33 99 33 99 99 99 99 99 99
99 99 99 33 33 33 99 33 99 33 99 33 99 33 99 33 99 33 99 99 33 99 99 99 33 99 33 99 33 99 33 99 33 99 33 99 99 99 33 99 33 99 33 99 33 99 33 99 99 99
99 99 99 99 99 99 33 99 33 99 33 99 33 99 33 99 33 99 99 99 99 33 99 33 99 33 99 33 99 33 99 33 99 33 99 33 99 33 99 33 99 33 99 33 99 33 99 33 99 99
99 99 99 33 33 33 99 33 99 33 99 33 99 33 99 33 99 33 99 99 33 99 33 99 33 99 33 99 33 99 33 99 33 99 33 99 33 99 33 99 33 99 33 99 33 99 33 99 99 99
99 99 99 99 99 99 99 99 99 99 99 99 99 99 99 99 99 99 99 99 99 99 99 99 99 99 99 99 99 99 99 99 99 99 99 99 99 99 99 99 99 99 99 99 99 99 99 99 99 99
99 99 99 99 99 99 99 99 99 99 99 99 99 99 99 99 99 99 99 99 99 99 99 99 99 99 99 99 99 99 99 99 99 99 99 99 99 99 99 99 99 99 99 99 99 99 99 99 99 99
99 99 99 99 99 99 99 99 99 99 99 99 99 99 99 99 99 99 99 99 99 99 99 99 99 99 99 99 99 99 99 99 99 99 99 99 99 99 99 99 99 99 99 99 99 99 99 99 99 99
99 99 99 99 33 33 33 99 33 33 33 99 99 33 99 33 33 99 99 99 99 33 33 99 99 99 33 33 33 33 33 33 99 99 99 99 33 33 33 33 33 33 33 33 99 33 33 33 99 99
99 99 99 99 99 99 99 33 99 99 99 99 33 99 33 99 99 33 99 99 33 99 99 33 99 33 99 99 99 99 99 99 33 99 99 33 99 99 99 99 99 99 99 99 33 99 99 99 99 99
99 99 99 99 99 33 99 99 99 33 33 99 99 99 99 99 33 99 99 99 99 33 33 99 99 99 99 99 99 99 99 99 33 99 99 33 99 99 99 99 99 99 99 99 99 33 99 33 99 99
99 99 99 33 99 99 99 33 33 99 99 99 99 99 33 33 99 99 99 99 33 99 99 99 99 33 99 99 99 99 99 99 33 99 99 33 99 99 99 99 99 99 99 99 99 99 33 99 99 99
99 99 99 99 33 33 33 99 99 99 33 99 99 33 99 99 33 33 99 99 99 33 33 99 33 99 99 99 33 33 33 33 33 99 99 33 33 33 33 33 99 99 99 99 33 33 99 33 99 99
99 99 99 33 99 99 99 99 99 99 99 99 99 99 33 99 99 99 99 99 33 99 99 99 99 99 99 33 99 99 99 99 99 99 99 99 99 99 99 99 33 99 99 99 99 99 33 99 99 99
99 99 99 99 33 33 99 99 33 99 99 99 99 33 99 33 33 33 99 99 99 33 33 99 99 99 99 33 99 99 99 99 99 99 99 99 99 99 99 99 33 99 99 99 99 33 99 33 99 99
99 99 99 99 99 99 33 99 99 33 99 99 33 99 33 99 99 99 33 99 33 99 99 99 99 99 99 33 99 99 99 99 99 99 99 99 99 99 99 99 33 99 99 99 99 99 33 99 99 99
99 99 99 99 33 33 99 33 99 99 99 99 99 99 99 99 99 33 99 99 99 33 33 99 99 99 99 33 99 99 99 99 99 99 99 99 99 99 99 99 33 99 99 99 33 99 99 33 99 99
99 99 99 33 99 99 99 99 99 99 99 99 99 99 99 99 99 99 33 99 33 99 99 99 99 99 99 33 99 99 99 99 99 99 99 99 99 99 99 99 33 99 99 99 99 99 33 99 99 99
99 99 99 99 99 33 33 99 99 99 99 99 99 99 99 99 99 33 99 99 99 33 33 99 99 99 99 33 99 99 99 99 99 99 99 99 99 99 99 99 33 99 99 99 33 99 99 33 99 99
99 99 99 33 33 99 99 99 99 99 99 99 99 99 99 99 33 99 99 99 33 99 99 99 99 99 99 33 99 99 99 99 99 99 99 99 99 99 99 99 33 99 99 99 99 33 33 99 99 99
99 99 99 99 99 33 99 99 99 99 99 99 99 99 33 33 99 99 99 99 99 33 33 99 99 99 99 99 33 33 33 33 33 33 33 33 33 33 33 33 99 99 99 99 33 99 99 99 99 99
99 99 99 99 33 99 33 99 99 99 99 99 99 99 99 99 33 33 99 99 33 99 99 99 99 99 99 99 99 99 99 99 99 99 99 99 99 99 99 99 99 99 99 99 99 33 33 99 99 99
99 99 99 33 99 33 99 99 99 99 99 99 99 99 33 33 99 99 99 99 99 33 33 99 99 99 99 33 33 33 33 33 33 33 33 33 33 33 33 33 33 99 99 99 99 99 99 33 99 99
99 99 99 99 33 99 99 99 99 99 99 99 99 99 99 99 33 33 99 99 33 99 99 99 99 99 99 99 99 99 99 99 99 99 99 99 99 99 99 99 99 99 99 99 99 99 33 99 99 99
99 99 99 33 99 33 99 99 99 99 99 99 99 99 99 33 99 99 99 99 99 33 33 33 33 33 33 33 33 33 33 33 33 33 33 33 33 33 33 33 33 33 33 33 33 33 99 33 99 99
99 99 99 99 33 99 33 33 33 33 33 33 33 33 33 99 33 99 99 99 99 99 99 99 99 99 99 99 99 99 99 99 99 99 99 99 99 99 99 99 99 99 99 99 99 99 99 99 99 99
99 99 99 99 99 99 99 99 99 99 99 99 99 99 99 99 99 99 99 99 99 99 99 99 99 99 99 99 99 99 99 99 99 99 99 99 99 99 99 99 99 99 99 99 99 99 99 99 99 99
99 99 99 99 99 99 99 99 99 99 99 99 99 99 99 99 99 99 99 99 99 99 99 99 99 99 99 99 99 99 99 99 99 99 99 99 99 99 99 99 99 99 99 99 99 99 99 99 99 99
99 99 99 99 99 99 99 99 99 99 99 99 99 99 99 99 99 99 99 99 99 99 99 99 99 99 99 99 99 99 99 99 99 99 99 99 99 99 99 99 99 99 99 99 99 99 99 99 99 99
99 99 99 99 99 99 99 99 99 99 99 99 99 99 99 99 99 99 99 99 99 99 99 99 99 99 99 99 99 99 99 99 99 99 99 99 99 99 99 99 99 99 99 99 99 99 99 99 99 99